13
WWWWWWWWWWWWWW
WPTPPTWWWWPWPW
WPTPWWWWPPPWPW
WWWPWPWPPWPPPW
WPPPPPWTPWPPWW
WPPPWTWWWWWPTW
WTWPWWWTPPPPTW
WPWPWPWWWWWPPW
WWWTTWWWWPPPPW
WPPPPTTPPPWPPW
WWTPPPPWPPTPTW
WTPPPWWWWPPWWW
WWWWWWWWWWWWWW
6
M,3,9,100,R,0,10
M,3,11,100,R,1,0
M,5,9,100,P,0,0
M,3,1,100,R,0,0
M,6,5,100,R,0,10
M,10,3,100,P,0,0
0
3
ACD,4
MIN,4
PDL,4
EMP,4
RTR,4
RTP,4
DMC,4
LTG,4
0
0
180
12