13
WWWWWWWWWWWWWW
WPTPPTWWWWPWPW
WPTPWWWWPPPWPW
WWWPWPWPPWPPPW
WPPPPPWTPWPPWW
WPPPWTWWWWWPTW
WTWPWWWTPPPPTW
WPWPWPWWWWWPPW
WWWTTWWWWPPPPW
WPPPPTTPPPWPPW
WWTPPPPWPPTPTW
WTPPPWWWWPPWWW
WWWWWWWWWWWWWW
6
M,3,9,100,R,0,10
M,3,11,100,P,1,0
M,6,9,100,P,0,0
M,1,1,100,R,0,0
M,6,5,100,R,0,10
M,10,3,100,P,0,0
0
3
EMP,4
RML,4
LNG,4
0
0
180
12