1
14
13
WWWWWWWWWWWWWW
WWPTPPPWWWPWPW
WPTPWWTWPPPWPW
WWWPWPPPPPPWPW
WPTPPPWTPWWWPW
WPWWPPWTPWWPTW
WPWPPWPWWWPPPW
WPWTWPPWPWWPPW
WPPTTWWWWPPWWW
WPPPPTTWWPPWWW
WWWWTTPWPPTTTW
WPPPPPPWWPPPTW
WWWWWWWWWWWWWW
6
M,3,9,100,R,0,10
M,3,11,100,P,1,0
M,7,4,100,P,0,0
M,1,10,100,R,0,0
M,6,5,100,R,0,10
M,10,3,100,P,0,0
0
8
ACD,4
MIN,4
PDL,4
EMP,4
RTR,4
RTP,4
DMC,4
LTG,4
0
0
180
12
70