1
14
13
WWWWWWWWWWWWWW
WPPPPPPWWWPWPW
WWTPWWTWPPPWPW
WWWPWPPPPWPPPW
WPPPPPWTPWPPWW
WPPPWTPTPWWPTW
WPWPWWWTPPPPTW
WPWPWPPWWWWPPW
WPPTTWWWWPPWWW
WPPPPTTWWPPWWW
WWTPPPPWPPTTTW
WTPPPWWWWPPPTW
WWWWWWWWWWWWWW
6
M,3,9,100,R,0,10
M,3,11,100,P,1,0
M,6,9,100,P,0,0
M,1,1,100,R,0,0
M,6,5,100,R,0,10
M,10,3,100,P,0,0
0
5
EMP,4
RTP,4
RTR,4
LTG,4
DMC,4
0
0
180
12
50
